NO ./path_to_the_north_texture.xpm
SO ./path_to_the_south_texture.xpm
WE ./path_to_the_west_texture.xpm
EA ./path_to_the_east_texture.xpm
F 220,100,0
C 225,30,0

1111111111111111111111111
1000N00000110000000000001
1011000001110000000000001
10010000000000000000000011111111
111111111011000001110000000000001
100000000011000001110111111111111
11110111111111011100000010001
11110111111111011101010010001
11000000110101011100000010001
10000000000000001100000010001  111111
10000000000000001101010000001  100101
1100000111010101111101111000111100101
11110111 1110101 101111010001011100001
11110111 1110101 101111010001011111011
11111111 1111111 111111111111     111     