NO map/path_to_the_north_texture.xpm
SO map/path_to_the_south_texture.xpm
WE map/path_to_the_west_texture.xpm
EA map/path_to_the_east_texture.xpm
F 220,100,0
C 225,30,0

111111111111
1000N0000011
1111111111111111111111111