NO map/path_to_the_north_texture.xpm
SO map/path_to_the_south_texture.xpm
WE map/path_to_the_west_texture.xpm
EA map/path_to_the_east_texture.xpm
F 220,100,0
C 225,30,0

111111111111
100000010001
10010N010101 1
100100010101   11
111111111111
100000000011
101111111111
100000000001
111111111111