NO map/no.xpm
SO map/so.xpm
WE map/we.xpm
EA map/ea.xpm
C 32,178,170
F 34,139,34

1111111
1000001
1000001
100W001
1000001
1000001
1111111