NO map/no.xpm
SO map/so.xpm
WE map/we.xpm
EA map/ea.xpm
C 32,178,170
F 34,139,34

111111111111111111111111111111111111111111111111111111111111
100000000000000000000000000000000000000000000000000100000001
1000W000000000000000000000000000000000000000001000100000001
100000000000000000000001111110000000000000000001111100000001
100000000000000000000001000000000000000000000001000000000001
100000000000000000000001000000000001111111111111000000000001
100000000000000000000001000000000000000010000001111111110001
100000000001111111111111000001100000000010000001000000000001
101000000000000000000000000000110000000010000000000000000001
101000000000000000000000000000010000000000000000000010000001
111000000000000000111110000000000000000000000000000010000001
100000000000000000000000000000000000000000000000000010000001
100000000000000000000000000000000001111111111111111111000001
100001000000000000000000100000000000000010000000000000000001
100001000000000000000000100000000000000010000000001000000001
100001000000000100000000100000000000000010000000001000000001
100001000000000100000000100000000000000000000000001000000001
100001000000000100000000100000000000000000000000001000000001
111111111111111111111111111111111111111111111111111111111111
