NO map/santo_N.xpm
SO map/santo_E.xpm
WE map/santo_W.xpm
EA map/santo_S.xpm
C 153,204,255
F 255,254,250

1111111111111
1001100010111
1001110000011
1011011000W01
1001110000011
1001100010011
1111110111111
1111111111111