NO map/winter.xpm
SO map/summer.xpm
WE map/fall.xpm
EA map/spring.xpm
C 208,250,255
F 245,245,245

11111111111111111111111111111111111111111111111111
10101010001010101010101010101010000000001000000001
10101010101111111111111111111111010111110011111111
10001010100000000000000111000111110101110101000001
11011010101010111111110111110111110100010001011111
10000000101110101111110000000000000111011101011001
11111111101010111011000111111111011100010101111111
10000000001110101011000000001101100000111100000001
101111101000111111110000N0000000001111111111111111
10001010001110000000000000001000101010101010101011
11111110111010111111111110111101111010111111111111
10000000101110100010000010100000000000101010101011
11111110111110101010101110111111110111010111111111
10000000000000001000100000001010101010101010101011
11111111111111111111111111111111111111111111111111